1111111111111111
1M00000000000M01
1000C110011111C1
1000111001101101
1001101000011M01
1011111100110001
10M0001001100M01
100M0010C11111C1
1P0000C0ME00C001
1111111111111111